date,vaccinated_min,vaccinated_max,vaccinated,fully_vaccinated_min,fully_vaccinated_max,fully_vaccinated,single_dose_vaccinated_min,single_dose_vaccinated_max,single_dose_vaccinated,total_vaccinations
2021-01-03,0,0,0,0,0,0,0,0,0,
2021-01-04,4822,4822,4822,0,0,0,4822,4822,4822,
2021-01-05,9643,9643,9643,0,0,0,9643,9643,9643,
2021-01-06,14465,14465,14465,0,0,0,14465,14465,14465,
2021-01-07,19286,19286,19286,0,0,0,19286,19286,19286,
2021-01-08,24108,24108,24108,0,0,0,24108,24108,24108,
2021-01-09,28929,28929,28929,0,0,0,28929,28929,28929,
2021-01-10,33751,33751,33751,0,0,0,33751,33751,33751,
2021-01-11,39918,39918,39918,0,0,0,39918,39918,39918,
2021-01-12,46084,46084,46084,0,0,0,46084,46084,46084,
2021-01-13,52251,52251,52251,0,0,0,52251,52251,52251,
2021-01-14,58418,58418,58418,0,0,0,58418,58418,58418,
2021-01-15,64585,64585,64585,0,0,0,64585,64585,64585,
2021-01-16,70751,70751,70751,0,0,0,70751,70751,70751,
2021-01-17,76918,76918,76918,0,0,0,76918,76918,76918,
2021-01-18,89678,89678,89678,0,0,0,89678,89678,89678,
2021-01-19,102439,102439,102439,0,0,0,102439,102439,102439,
2021-01-20,115199,115199,115199,0,0,0,115199,115199,115199,
2021-01-21,127959,127959,127959,0,0,0,127959,127959,127959,
2021-01-22,140719,140719,140719,0,0,0,140719,140719,140719,
2021-01-23,148658,153480,151069,0,0,0,143836,153480,148658,
2021-01-24,156597,166240,161418,0,0,0,146954,166240,156597,
2021-01-25,178253,192718,185486,0,0,0,163788,192718,178253,
2021-01-26,199908,219194,209551,0,19286,9643,180622,219194,199908,
2021-01-27,221564,245672,233618,0,24108,12054,197456,245672,221564,
2021-01-28,243219,272148,257684,0,28929,14464,214290,272148,243219,
2021-01-29,264875,293804,279340,4822,33751,19286,231124,288982,260053,
2021-01-30,285184,315459,300322,9643,39918,24780,245266,305816,275541,
2021-01-31,305496,337115,321306,14465,46084,30274,259412,322650,291031,
2021-02-01,330742,363707,347224,19286,52251,35768,278491,344421,311456,
2021-02-02,355987,390297,373142,24108,58418,41263,297569,366189,331879,
2021-02-03,381233,416889,399061,28929,64585,46757,316648,387960,352304,
2021-02-04,406480,443480,424980,33751,70751,52251,335729,409729,372729,
2021-02-05,431726,468726,450226,39918,76918,58418,354808,428808,391808,
2021-02-06,450745,493972,472358,46084,89311,67698,361434,447888,404661,
2021-02-07,469765,519218,494492,52251,101704,76978,368061,466967,417514,
2021-02-08,500697,543983,522340,58418,101704,80061,398993,485565,442279,
2021-02-09,531627,568746,550186,64585,101704,83144,429923,504161,467042,
2021-02-10,550166,593512,571839,70751,114097,92424,436069,522761,479415,
2021-02-11,568704,618275,593490,76918,126489,101704,442215,541357,491786,
2021-02-12,587243,636814,612028,89311,138882,114096,448361,547503,497932,
2021-02-13,610235,655351,632793,101704,146820,124262,463415,553647,508531,
2021-02-14,633227,686283,659755,101704,154760,128232,478467,584579,531523,
2021-02-15,647742,721919,684830,101704,175881,138792,471861,620215,546038,
2021-02-16,662254,757553,709904,101704,197003,149354,465251,655849,560550,
2021-02-17,676769,793189,734979,101704,218124,159914,458645,691485,575065,
2021-02-18,691282,828824,760053,101704,239246,170475,452036,727120,589578,
2021-02-19,705797,864460,785128,101704,260367,181036,445430,762756,604093,
2021-02-20,721121,887701,804411,114097,280677,197387,440444,773604,607024,
2021-02-21,736446,910945,823696,126489,300988,213738,435458,784456,609957,
2021-02-22,760350,947748,854049,138882,326280,232581,434070,808866,621468,
2021-02-23,784256,984185,884220,151642,351571,251606,432685,832543,632614,
2021-02-24,808160,1020620,914390,164403,376863,270633,431297,856217,643757,
2021-02-25,832065,1043874,937970,190346,402155,296250,429910,853528,641719,
2021-02-26,880359,1067127,973743,216289,403057,309673,477302,850838,664070,
2021-02-27,928700,1090381,1009540,242232,403913,323072,524787,848149,686468,
2021-02-28,977041,1113634,1045338,268175,404768,336472,572273,845459,708866,
2021-03-01,1018208,1134536,1076372,289296,405624,347460,612584,845240,728912,
2021-03-02,1059375,1154903,1107139,310952,406480,358716,652895,843951,748423,
2021-03-03,1100542,1175271,1137906,332607,407336,369972,693206,842664,767935,
2021-03-04,1141711,1190657,1166184,359245,408191,383718,733520,831412,782466,
2021-03-05,1158488,1206044,1182266,385881,433437,409659,725051,820163,772607,
2021-03-06,1181439,1221429,1201434,412519,452509,432514,728930,808910,768920,
2021-03-07,1204391,1236816,1220604,439155,471580,455368,732811,797661,765236,
2021-03-08,1220578,1276497,1248538,440057,495976,468016,724602,836440,780521,
2021-03-09,1236765,1316222,1276494,440913,520370,480642,716395,875309,795852,
2021-03-10,1263520,1355950,1309735,441768,534198,487983,729322,914182,821752,
2021-03-11,1303563,1395677,1349620,442624,534738,488681,768825,953053,860939,
2021-03-12,1343606,1435404,1389505,443480,535278,489379,808328,991924,900126,
2021-03-13,1382271,1475129,1428700,444336,537194,490765,845077,1030793,937935,
2021-03-14,1420939,1514857,1467898,445191,539109,492150,881830,1069666,975748,
2021-03-15,1431869,1544402,1488136,446047,558580,502314,873289,1098355,985822,
2021-03-16,1442798,1573894,1508346,446955,578051,512503,864747,1126939,995843,
2021-03-17,1453728,1578998,1516363,472252,597522,534887,856206,1106746,981476,
2021-03-18,1460373,1584101,1522237,497551,621279,559415,839094,1086550,962822,
2021-03-19,1467016,1589205,1528110,522848,645037,583942,821979,1066357,944168,
2021-03-20,1495550,1594916,1545233,547537,646903,597220,848647,1047379,948013,
2021-03-21,1524083,1600630,1562356,572224,648771,610498,875312,1028406,951859,
2021-03-22,1564689,1619269,1591979,596057,650637,623347,914052,1023212,968632,
2021-03-23,1602491,1636531,1619511,621266,655306,638286,947185,1015265,981225,
2021-03-24,1640297,1657453,1648875,642816,659972,651394,980325,1014637,997481,
2021-03-25,1678054,1680087,1679070,662653,664686,663670,1013368,1017434,1015401,
2021-03-26,1697351,1715813,1706582,669399,687861,678630,1009490,1046414,1027952,
2021-03-27,1730516,1753698,1742107,673985,697167,685576,1033349,1079713,1056531,
2021-03-28,1770705,1790240,1780472,679915,699450,689682,1071255,1110325,1090790,
2021-03-29,1832713,1848601,1840657,685845,701733,693789,1130980,1162756,1146868,
2021-03-30,1870681,1905180,1887930,693557,728056,710806,1142625,1211623,1177124,
2021-03-31,1909016,1961761,1935388,701267,754012,727640,1155004,1260494,1207749,
2021-04-01,1947351,2018393,1982872,708925,779967,744446,1167384,1309468,1238426,
2021-04-02,1985686,2075026,2030356,716583,805923,761253,1179763,1358443,1269103,
2021-04-03,2024022,2107209,2065616,748691,831878,790284,1192144,1358518,1275331,
2021-04-04,2074750,2139393,2107072,780798,845441,813120,1229309,1358595,1293952,
2021-04-05,2152944,2199042,2175993,812906,859004,835955,1293940,1386136,1340038,
2021-04-06,2224506,2260052,2242279,843655,879201,861428,1345305,1416397,1380851,
2021-04-07,2296603,2321058,2308830,874406,898861,886634,1397742,1446652,1422197,
2021-04-08,2368697,2383442,2376070,903779,918524,911152,1450173,1479663,1464918,
2021-04-09,2445823,2453976,2449900,925002,933155,929078,1512668,1528974,1520821,
2021-04-10,2532442,2539254,2535848,931483,938295,934889,1594147,1607771,1600959,
2021-04-11,2612831,2624534,2618682,937960,949663,943812,1663168,1686574,1674871,
2021-04-12,2716714,2733302,2725008,944441,961029,952735,1755685,1788861,1772273,
2021-04-13,2830489,2838919,2834704,954075,962505,958290,1867984,1884844,1876414,
2021-04-14,2944264,2944488,2944376,963755,963979,963867,1980285,1980733,1980509,
2021-04-15,3047955,3050056,3049006,973436,975537,974486,2072418,2076620,2074519,
2021-04-16,3138728,3160607,3149668,978134,1000013,989074,2138715,2182473,2160594,
2021-04-17,3226536,3271159,3248848,982833,1027456,1005144,2199080,2288326,2243703,
2021-04-18,3314346,3381710,3348028,987531,1054895,1021213,2259451,2394179,2326815,
2021-04-19,3380229,3470336,3425282,993500,1083607,1038554,2296622,2476836,2386729,
2021-04-20,3459580,3538173,3498876,1020257,1098850,1059554,2360730,2517916,2439323,
2021-04-21,3538934,3606064,3572499,1046961,1114091,1080526,2424843,2559103,2491973,
2021-04-22,3618160,3673878,3646019,1073743,1129461,1101602,2488699,2600135,2544417,
2021-04-23,3702205,3741691,3721948,1100525,1140011,1120268,2562194,2641166,2601680,
2021-04-24,3786153,3809503,3797828,1127307,1150657,1138982,2635496,2682196,2658846,
2021-04-25,3847728,3877319,3862524,1154086,1183677,1168882,2664051,2723233,2693642,
2021-04-26,3914000,3949831,3931916,1185247,1221078,1203162,2692922,2764584,2728753,
2021-04-27,3975120,4016010,3995565,1222744,1263634,1243189,2711486,2793266,2752376,
2021-04-28,4039040,4082192,4060616,1260235,1303387,1281811,2735653,2821957,2778805,
2021-04-29,4103018,4163727,4133372,1282375,1343084,1312730,2759934,2881352,2820643,
2021-04-30,4166996,4245263,4206130,1304512,1382779,1343646,2784217,2940751,2862484,
2021-05-01,4232005,4326799,4279402,1326652,1421446,1374049,2810559,3000147,2905353,
2021-05-02,4297379,4407726,4352552,1349398,1459745,1404572,2837634,3058328,2947981,
2021-05-03,4386382,4510932,4448657,1373220,1497770,1435495,2888612,3137712,3013162,
2021-05-04,4449455,4617808,4533632,1393373,1561726,1477550,2887729,3224435,3056082,
2021-05-05,4514311,4725168,4619740,1413041,1623898,1518470,2890413,3312127,3101270,
2021-05-06,4579318,4822188,4700753,1443047,1685917,1564482,2893401,3379141,3136271,
2021-05-07,4644329,4917495,4780912,1474768,1747934,1611351,2896395,3442727,3169561,
2021-05-08,4709744,5018175,4863960,1501117,1809548,1655332,2900196,3517058,3208627,
2021-05-09,4800086,5102949,4951518,1543371,1846234,1694802,2953852,3559578,3256715,
2021-05-10,4913867,5204145,5059006,1590076,1880354,1735215,3033513,3614069,3323791,
2021-05-11,5025282,5288129,5156706,1653992,1916839,1785416,3108443,3634137,3371290,
2021-05-12,5134970,5395544,5265257,1694478,1955052,1824765,3179918,3701066,3440492,
2021-05-13,5247625,5507741,5377683,1730181,1990297,1860239,3257328,3777560,3517444,
2021-05-14,5360278,5619942,5490110,1765881,2025545,1895713,3334733,3854061,3594397,
2021-05-15,5472521,5732140,5602330,1801583,2061202,1931392,3411319,3930557,3670938,
2021-05-16,5560327,5844341,5702334,1837283,2121297,1979290,3439030,4007058,3723044,
2021-05-17,5657437,5947223,5802330,1883777,2173563,2028670,3483874,4063446,3773660,
2021-05-18,5733239,6043314,5888276,1937062,2247137,2092100,3486102,4106252,3796177,
2021-05-19,5798616,6146221,5972418,1983531,2331136,2157334,3467480,4162690,3815085,
2021-05-20,5864090,6245571,6054830,2033556,2415037,2224296,3449053,4212015,3830534,
2021-05-21,5933319,6344923,6139121,2083580,2495184,2289382,3438135,4261343,3849739,
2021-05-22,6016138,6431090,6223614,2146789,2561741,2354265,3454397,4284301,3869349,
2021-05-23,6099006,6517257,6308132,2209998,2628249,2419124,3470757,4307259,3889008,
2021-05-24,6182052,6598743,6390398,2284589,2701280,2492934,3480772,4314154,3897463,
2021-05-25,6259348,6661990,6460669,2377421,2780063,2578742,3479285,4284569,3881927,
2021-05-26,6323145,6728486,6525816,2467002,2872343,2669672,3450802,4261484,3856143,
2021-05-27,6387043,6809327,6598185,2542239,2964523,2753381,3422520,4267088,3844804,
2021-05-28,6456519,6890167,6673343,2617476,3051124,2834300,3405395,4272691,3839043,
2021-05-29,6529025,6966027,6747526,2697695,3134697,2916196,3394328,4268332,3831330,
2021-05-30,6601530,7041886,6821708,2777913,3218269,2998091,3383261,4263973,3823617,
2021-05-31,6720520,7141855,6931188,2865225,3286560,3075892,3433960,4276630,3855295,
2021-06-01,6819484,7236802,7028143,2957563,3374881,3166222,3444603,4279239,3861921,
2021-06-02,6913825,7354656,7134240,3026990,3467821,3247406,3446004,4327666,3886835,
2021-06-03,7005369,7458783,7232076,3110148,3563562,3336855,3441807,4348635,3895221,
2021-06-04,7096909,7562224,7329566,3193988,3659303,3426646,3437606,4368236,3902921,
2021-06-05,7188452,7665667,7427060,3277830,3755045,3516438,3433407,4387837,3910622,
2021-06-06,7278861,7769796,7524328,3360982,3851917,3606450,3426944,4408814,3917879,
2021-06-07,7426187,7930554,7678370,3429401,3933768,3681584,3492419,4501153,3996786,
2021-06-08,7549589,8087772,7818680,3501363,4039546,3770454,3510043,4586409,4048226,
2021-06-09,7687683,8249043,7968363,3569269,4130629,3849949,3557054,4679774,4118414,
2021-06-10,7823992,8406829,8115410,3640660,4223497,3932078,3600495,4766169,4183332,
2021-06-11,7960150,8540223,8250186,3736443,4316516,4026480,3643634,4803780,4223707,
2021-06-12,8096306,8673621,8384964,3832225,4409540,4120882,3686766,4841396,4264081,
2021-06-13,8232058,8806328,8519193,3928695,4502965,4215830,3729093,4877633,4303363,
2021-06-14,8338726,8930336,8634531,4023357,4614967,4319162,3723759,4906979,4315369,
2021-06-15,8425698,9041218,8733458,4131147,4746667,4438907,3679031,4910071,4294551,
2021-06-16,8520354,9148432,8834393,4242603,4870681,4556642,3649673,4905829,4277751,
2021-06-17,8616739,9244399,8930569,4365309,4992969,4679139,3623770,4879090,4251430,
2021-06-18,8710155,9344389,9027272,4483989,5118223,4801106,3591932,4860400,4226166,
2021-06-19,8803575,9446094,9124834,4600956,5243475,4922216,3560100,4845138,4202619,
2021-06-20,8897403,9542426,9219914,4723294,5368317,5045806,3529086,4819132,4174109,
2021-06-21,9014293,9653287,9333790,4832431,5471425,5151928,3542868,4820856,4181862,
2021-06-22,9114376,9751465,9432920,4954248,5591337,5272792,3523039,4797217,4160128,
2021-06-23,9232165,9866856,9549510,5058855,5693546,5376200,3538619,4808001,4173310,
2021-06-24,9360379,9958816,9659598,5186892,5785329,5486110,3575050,4771924,4173487,
2021-06-25,9488496,10051315,9769906,5314391,5877210,5595800,3611286,4736924,4174105,
2021-06-26,9606046,10143808,9874927,5441893,5979655,5710774,3626391,4701915,4164153,
2021-06-27,9710008,10236306,9973157,5569393,6095691,5832542,3614317,4666913,4140615,
2021-06-28,9821937,10336817,10079377,5705735,6220615,5963175,3601322,4631082,4116202,
2021-06-29,9945068,10439144,10192106,5840259,6334335,6087297,3610733,4598885,4104809,
2021-06-30,10073952,10548263,10311108,5967993,6442304,6205148,3631648,4580270,4105959,
2021-07-01,10216334,10650567,10433450,6102542,6536775,6319658,3679559,4548025,4113792,
2021-07-02,10358615,10752824,10555720,6237138,6631347,6434242,3727268,4515686,4121477,
2021-07-03,10500894,10855078,10677986,6371735,6725919,6548827,3774975,4483343,4129159,
2021-07-04,10647996,10970518,10809257,6493148,6815670,6654409,3832326,4477370,4154848,
2021-07-05,10772347,11063207,10917777,6593916,6884776,6739346,3887571,4469291,4178431,
2021-07-06,10861881,11167102,11014492,6683480,6988701,6836090,3873180,4483622,4178401,
2021-07-07,10954958,11289236,11122097,6754803,7089081,6921942,3865877,4534433,4200155,
2021-07-08,11052657,11408122,11230390,6829376,7184841,7007108,3867816,4578746,4223281,
2021-07-09,11153154,11527055,11340104,6903900,7277801,7090850,3875353,4623155,4249254,
2021-07-10,11253653,11645991,11449822,6978423,7370761,7174592,3882892,4667568,4275230,
2021-07-11,11354151,11769907,11562029,7047964,7463720,7255842,3890431,4721943,4306187,
